NO ./textures/wall/front.xpm
SO ./textures/wall/front.xpm
WE ./textures/wall/side.xpm
EA ./textures/wall/side.xpm

F 220,100,0
C 225,30,0

111111
101001
100001
1W0001
111111
